!Sori:   !| #####################################################
!Scor:   !| #                                                   #
!        !| #                                                   #
!        !| #                                                   #
!!!!!!!!!!| #####################################################
  Plante  | -----------------------------------------------------
          | ##### ##### ##### ##### ##### ##### ##### ##### #####
          | #   # #   # #   # #   # #   # #   # #   # #   # #   #
          | #   # #   # #   # #   # #   # #   # #   # #   # #   #
          | #   # #   # #   # #   # #   # #   # #   # #   # #   #
          | ##### ##### ##### ##### ##### ##### ##### ##### #####